91919191919191919191919191919191919191919
67000000000700000070000000000000000000076
60000000000000000000000000000000000000006
60000070000000000000000000000000700600006
60000006666666666600700000000000000600006
60000066000000000000000666666666666600006
60000660000000700000007000600000000600006
60700600000000000000000000600070000600006
60000600066666000000000000600000000600006
60000600000000000000070000600000000000006
60000007000000000051000000600000000000006
60000000000000000000000000000000000000006
60000000000000000000000000000000000007006
60000000440000440007440000440000440000006
08070000110000110000110000110000110000006
60000000000000000000000000000000007000006
60000000000000000000007000000000000000080
60000000007000000000000000000000000000006
60000000000000000000000000000000000000706
60000000000000000070000044000000000000006
60000440000000000000000011000700000000006
60007110000070000000000000000000000000006
60000510000000000000000000000000000000006
60000000000021111000000000000000000007006
60000070000011111000000070000000000000006
60000000000011111000000000000051400000006
60000000000000000000000000000051100000006
60000000000000000700000000000000070000006
60000000007000000000000000000000000000006
60070000000000000000000000000000000000006
60000000000000000008000007000000000000706
66666666666666666660666666666666666666666