66666666666666666666666666666666666666666
60000070000000007000000005130700000000006
60000000070000000000000005110000000070006
60000000000000000000000004510000000000006
60000004510007000000000001510000000000006
60000001510000000070000000000000000000006
60000004340000000000000000000000000000006
60000001110000000510007000000000044000006
65100000000000000340000000070000011000006
65100000000000000110000021111000000004346
64300000000000000510000011111000000001116
61100000000000000000000011111000000000006
60000000000000000000000000000000000000006
60000000211110000007000000000700000000006
68000000111110000000000000000000000070086
60000070111110000000335100000007000000006
60000000000000000000115100000000000000006
60000000700000007000513400000000000000006
60000000000000000000511100000000000000006
60000000000000070000000000000002111100006
60000000051000000000000000000001111100006
60000000051000051000000700000001111100006
60007070034000051000000000000000000000006
60000000011000000000051000000000000000346
60000000044000000000051000000007000000116
65151000011000000000034000000000000000516
65151000000070000000011000000000000700516
60070000000000000000000000005151000000006
60000000000000000000000700005151000007006
60000070000005143000000070000000000000006
60070000000005111000000000000000000700006
66666666666666666666666666666666666666666