91919191919191919191919191919191919191919
60000000000008000000000080000000008000006
60000000000000000700000000000000007000006
60000000000000000000000000000000000000006
60000000000000000000000000000000000000006
60000007000000000000000000000000000000006
60000066666000006666600000666660000066666
60000066666000706666600000666660000066666
60000066666000006666600000666660000066666
60000066666000006666600000666660000066666
60000066666000006666600000666660000066666
60000000000000000000700000000000000000006
60000000000007007000000000000000000000006
68000000000000000000000000000000000000086
60000000000000000007000000000000000000006
60000000000000000000000000000000000000006
60000066666000006666600000666660000066666
60000066666000006666600000666660000066666
60000066666000006666600000666660000066666
60000066666000006666600000666660000066666
60000066666700006666600000666660000066666
60000000000000000000000000000000000000006
60000000000000007777777770000000000000006
68000000000000000000000000000000000000086
60000000000000000000000000007777000000006
60000000007700000000000000000000000000006
60000066666000006666600000666660007066666
60000066666000006666600000666660000066666
60000066666000006666600000666660000066666
60000066666000006666600000666660000066666
60000066666000006666600000666660000066666
60000000000000000000000770000000000000006
60000000000700000000000000000000000000006
68000000000000000000000007770000000000086
60000000000000000000000000000000000000006
66666666666666666666666666666666666666666