91919191919191919191919191919191919191919
60000000000000000000000000000000000000006
60070000070000000000000000000000000000006
60000000000000000000000000000000000600006
60000000000000000000000000000000000600006
60000000000000000000000000000000000000006
60000660000000000000000000600000000600006
60000600000000000000000000600000000600006
60000600066666000000000000600000000600006
60000600000000000000000000600000000000006
60000000000000000051000000600000000000006
60000000000000000000000000000000000000006
60000000000000000000000000000000000000006
60000000440000440000440000440000440000006
68000000110000110000110000110000110000006
60000000000000000000000000000000000000006
60000000000000000000000000000000000000006
60000000000000000000000000000000000000006
60000000000000000000000000000000000000006
60000000000000000000000044000000000000006
60000440000000000000000011000000000000806
60000110000000000000000000000000000000006
60000510000000000000000000000000000000006
60000000000021111000000000000000000000006
60000000000011111000000000000000000000006
60000000000011111000000000000051400000006
60000000000000000000000000000051100000006
60000000000000000000000000000000000000006
60000000000000000000000000000000000000006
60000000000000000000000000000000000000006
60000000000000000008000000000000000000006
66666666666666666666666666666666666666666